NO wall/NO.xpm																																			

SO wall/SO.xpm

WE wall/WE.xpm

EA wall/EA.xpm





F 155,155,155





C 100,100,100






1111111111111
1100000000111
1122333000001
1110000000011
1100000000111
110000000N11
111111111111111
